21 19
w w w w w w w w w w w w w w w w w w w
w g g g g g g g g w g g g g g g g g w
w s w w g w w w g w g w w w g w w s w
w g g g g g g g gf0 gf1 gf2 gf3 g g g g g g w
w g w w g w g w w w w w g w g w w g w
w g g g g w g g g w g g g w g g g g w
w w w w g w w w g w g w w w g w w w w
p p p w g w g g g gm g g g w g w p p p 
w w w w g w g w w w w w g w g w w w w 
g g g g g g g w p p p w g g g g g g g
w w w w g w g w w w w w g w g w w w w 
p p p w g w g g g g g g g w g w p p p
w w w w g w g w w w w w g w g w w w w
w g g g g g g g g w g g g g g g g g w
w g w w g w w w g w g w w w g w w g w
w g g w g g g g g g g g g g g w g g w
w w g w g w g w w w w w g w g w g w w
w g g g g w g g g w g g g w g g g g w
w s w w w w w w g w g w w w w w w s w
w g g g g g g g g g g g g g g g g g w
w w w w w w w w w w w w w w w w w w w